13
1
11
###E###
#     #
# # # #
#     #
#### ##
#     #
# # # #
#     #
##### #
#     #
# # # #
#     #
#######