5
3
1
####E###
# #    #
## ### #
#      #
########
