16
19
12 
############################################
#                     #   #    #      #    #
# ############## #      #   ## #  ### ###  #
# # # # #      ########## ## # # #       # #
# #              #        #  # # # ######  #
# ########### ## #######  #    # #         #
#              ###      # ###### #  ###### #
##############      ####         # #       #
#             ###      ############# #######
## ######## ##   ##### #         #         #
#      #  #    #       #         # ### ### #
##### ### ###     ###  # ######### ### ##  #
#         #  #####  #  #         #         #
########  #  #      #### ####### ######### #
E           #            #                 #
############################################
